1111111111111111111
1P100000000100V0001
1010111111010111101
1000010000010001001
111V111V11111101011
1010001000000001001
1000101111111111101
1111101000001W10001
1000001010111010111
1011111010100010001
1010V01010101V10101
1000100010101000101
1111111111111111111
